##########
#A     #B#
# ### ## #
#   #    #
### # ####
#     #  #
##########
